15x5
000000000100000
000011000100000
000001000100000
000001001100001
000001000000000
