9x8
000000000
000000000
111101111
000101000
000101000
000101000
000000000
000000000
