11x10
00001010000
00000000000
11111111101
10000011101
10101000001
10101010110
00000010000
01111111110
01000000010
00001010000
